BBBBBBBBBBBBBBBBBBBBBBBBBBBBAAAAAAAABBBBBBBBBBBBBBBBBBBBBBBBBBBB
BBBBBBBBBBBBBBBBBBBBBBBBBBBBAAAAAAAABBBBBBBBBBBBBBBBBBBBBBBBBBBB
BBBBBBBBBBBBBBBBBBBBBBBBBBBAAAAAAAAAABBBBBBBBBBBBBBBBBBBBBBBBBBB
BBBBAAAAAAAAAAAAAAAAAAAAAAAAAAAAAAAAAAAABBBBBBBBBBBBBBBBBBBBBBBB
BBBBAAAAAAAAAAAAAAAAAAAAAAAAAAAAAAAAAAAAAAAAAAAAAAAAAAAAAAAAAABB
BBBBAAAAAAAAAAAAAAAAAAAAAAAAAAAAAAAAAAAAAAAAAAAAAAAAAAAAAAAAAABB
BBBBAAAAAAAAAAAAAAAAAAAAAAAAAAAAAAAAAABBBBBBAAAAAAABBBBBBBBBBBBB
BBBBAAAAAAAAAAAAAAAAAAAAAAAAAAAAAAAAAABBBBBBAAAAAAABBBBBBBBBBBBB
BBBBAAAAAAAAAAAAAAAAAAAAAAAAAAAAAAAAAABBBBBBAAAAAAABBBBBBBBBBBBB
BBBBAAAAAAAAAAAAAAAAAAAAAAAAAAAAAAAAAABBBBBBAAAAAAABBBBBBBBBBBBB
BBBBAAAAAAAAAAAAAAAAAAAAAAAAAAAAAAAAAAAAAAAAAAAAAAAAAAAAAAABBBBB
BBBBAAAAAAAAAAAAAAAAAAAAAAAAAAAAAAAAAAAAAAAAAAAAAAAAAAAAAAABBBBB
BBBBAAAAAAAAABBBBBBBBBBAAAAAAAAAAAAAAAAAAAAAAAAAAAAAAAAAAAAABBBB
BBBBAAAAAAAAABBBBBBBBBBAAAAAAAAAAAAABBBBBBBBBBAAAAAAAAAAAAAABBBB
BBBBAAAAAAAAABBBBBBBBBBAAAAAABBBBBBBAAAAAAAAABAAAAAAAAAAAAAABBBB
BBBBAAAAAAAAABBBBBBBBBBAAAAAABAAAAAAAAAAAAAAABAAAAAAAAAAAAAABBBB
BBBBAAAAAAAAAAAAAAAAAAAAAAAAABAAAAAAAAAAAAAAABAAAAAAAAAAAAAABBBB
BBBBAAAAAAAAAAAAAAAAAAAAAAAAABBBBBBAAAAAAAAAABAAAAAAAAAAAAAABBBB
BBBBAAAAAAAAAAAAAAAAAAAAAAAAAAAAAABAAAAAAAAAAAAAAAAAAAAAAAAABBBB
BBBBAAAAAAAAAAAAAAAAAAAABBBBBBAAAABBBAAAAAAAAAAAAAAAAAAAAAAABBBB
BBBBAAAAAAAAAAAAAAAAAAAABBBBBBAAAAAABAAAAAAAAAAAAAAAAAAAAAAABBBB
BBBBAAAAAAAAAAAAAAAAAAAABBBBBBAAAAAABBBBBBBBBBAAAAAAAAAAAAAABBBB
BBBBAAAAAAAABBBBAAAAAAAABBBBBBAAAAAAAAAAAAAAAAAAAAAAAAAAAAAABBBB
BBBBAAAAAAAABBBBAAAAAAAAAAAAAAAAAAAAAAAAAAAAAAAAAAAAAAAAAAAABBBB
AAAAAAAAAAAABBBBAAAAAAAAAAAAAAAAAAAAAAAAAAAAAAAAAAAAAAAAAAAAABBB
AAAAAAAAAAAABBBBAAAAAAAAAAAAAAABAAAAAAAAAAAAAAAAAAAAABAAAAAAABBB
AAAAAAAAAAAAAAAAAAAAAAAAAAAAAAABBBBBBBBBBAAAABBBBBBBBBAAAAAAABBB
AAAAAAAAAAAAAAAAAAAAAAAAAAAAAAAAAAAAAAAABAAAABAAAAAAAAAAAAAAAABB
AAAAAAAAAAAAAAAAAAAAAAAAAAAAAAAAAAAAAAAABAAAABAAAAAAAAAAAAAAAAAA
AAAAAAAAAAAAAAAAAAAAAAAAAAAAAAAAAAAAAAAABAAAABAAAAAAAAAAAAAAAAAA
AAAAAAAAAAAAAAAAAAAAAAAAAAAAAAAAAAAAAAAABAAAABAAAAAAAAAAAAAAAAAA
AAAAAAAAAAAAAAAAAAAAAAAAAAAAAAAAAAAAAAAABAAAABAAAAAAAAAAAAAAAAAA
AAAAAAAAAAAAAAAAAAAAAAAAAAAAAAAAAAAAAAAABAAAABAAAAAAAAAAAAAAAAAA
AAAAAAAAAAAAAAAAABBBBBAAAAAAAAAAAAAAAAAABAAAABAAAAAAAAAAAAAAAAAA
AAAAAAAAAAAAAAAAABBBBBAAAAAAAAAAAAAAAAAABAAAABAAAAAAAAAAAAAAAAAA
AAAAAAAAAAAAAAAAABBBBBAAAAAAAAAAAAAAAAAABAAAABAAAAAAAAAAAAAAAAAA
AAAAAAAAAAAAAAAAABBBBBAAAAAAAAAAAAAAAAAABAAAABAAAAAAAAAAAAAAAABB
AAAAAAAAAAAABBBBBBBBBBBBBBBBBBBBBBBBBBBBBAAAABAAAAAAAAAAAAAAABBB
AAAAAAAAAAAABAAAAAAAAAAAAAAAAAAAAAAAAAAAAAAAABAAAAAAAAAAAAAAABBB
AAAAAAAAAAAABAAAAAAAAAAAAAAAAAAAAAAAAAAAAAAABBBAAAAAAAAAABBBBBBB
AAAAAAAAAAAABAAAAAAAAAAAAAAAAAAAAAAAAAAAAAAABBBAAAAAAAAAABBBBBBB
BBBBAAAAAAAABBBBBBBBBBBBBBBBBBBBBBBBBBBBBBBBBBAAAAAAAAAAAAAABBBB
BBBBAAAAAAAAAAAAAAAAAAAAAAAAAAAABBAAAAAAAAAAAAAAAAAAAAAAAAAABBBB
BBBBAAAAAAAAAAAAAAAAAAAAAAAAAAAABBAAAAAAAAAAAAAAAAAAAAAAAAAABBBB
BBBBAAAAAAAAAAAAAAAAAAAAAAAAAAAABBAAAAAAAAAAAAAAAAAAAAAAAAAABBBB
BBBBAAAAAAAAAAAAAAAAAAAAAAAAAAAABBAAAAAAAAAAAAAAAAAAAAAAAAAABBBB
BBBBAAAAAAAAAAAAAAAAAAAAAAAAAAAABBAAAAAAAAAAAAAAAAAAAAAAAAAABBBB
BBBBAAAAAAAAAAAAAAAAAAAAAAAAAAAABBAAAAAAAAAAAAAAAAAAAAAAAAAABBBB
BBBBAAAAAAAAABBBBBBBBBBBBBBBBBBBBBBBBBBBBBBBBBBBBBBBBBBAAAAABBBB
BBBBAAAAAAAAABBBBBBBBBBBBBBBBBBBBBBBBBBBBBBBBBBBBBBBBBBAAAAABBBB
BBBBAAAAAAAAAAAAAAAAAAAAAAAAAAAAAAAAABBBBBAAAAAAAAAAAAAAAAAABBBB
BBBBAAAAAAAAAAAAAABBBBBAAAAAAAAAAAAAAABBBBBAAAAAAAAAAAAAAAAAABBB
BBBBAAAAAAAAAAAAAABBBBBAAAAAAAAAAAAAAABBBBBAAAAAAAAAAAAAAAAABBBB
BBBBAAAAAAAAAAABBBBBBBBAAAAAAAAAAAAAAABBBBBAAAAAAAAAAAAAAAAABBBB
BBBBAAAAAAAAAAABBBBBBBBAAAAAAAAAAAAAAABBBBBAAAAAAAAAAAAAAAAABBBB
BBBBAAAAAAAAAAABBBBBAAAAAAAAAAAAAAAAABBBBBAAAAAAAAAAAAAAAABBBBBB
BBBBAAAAAAAAAAABBBBBAAAAAAAAAAAAAAAAABBBBBAAAAAAAAAAAAAAAABBBBBB
BBBBAAAAAAAABBBBBBBBAAAAAAAAAAAAAAAAABBBBBAAAAAAAAAAAAAAABBBBBBB
BBBBAAAAAAAABBBBBAAAAAAAAAAAAAAAAAAAAAAAAAAAAAAAAAAAAAABBBBBBBBB
BBBBAAAAAAAABBBBBAAAAAAAAAAAAAAAAAAAAAAAAAAAAAAAAAAABBBBBBBBBBBB
BBBBAAAAAAAABBBBBAAAAAAAAAAAAAAAAAAAAAAABBBBBBBBBBBBBBBBBBBBBBBB
BBBBBBBBBBBBBBBBBBBBBBBBBBBAAAAAAAAAABBBBBBBBBBBBBBBBBBBBBBBBBBB
BBBBBBBBBBBBBBBBBBBBBBBBBBBBAAAAAAAABBBBBBBBBBBBBBBBBBBBBBBBBBBB
BBBBBBBBBBBBBBBBBBBBBBBBBBBBAAAAAAAABBBBBBBBBBBBBBBBBBBBBBBBBBBB